{
    "levels": [
        {
            "name": "Polacy - naród wspaniały, tylko ludzie kurwy - Tadeusz Rydzyk",
            "img": "res/hell.jpg",
            "size": 20,
            "waves": 20,
            "enemyPerWave": 15,
            "lives": 10,
            "money": 500,
            "duration": 40,
            "values": [
                {
                    "interactive": true,
                    "img": "res/grass.jpeg"
                },
                {
                    "interactive": false,
                    "img": "res/road.jpeg"
                },
                {
                    "interactive": false,
                    "img": "res/gate.png"
                },
                {
                    "interactive": false,
                    "img": "res/gate.jpeg"
                }
            ],
            "tiles":  [0,0,0,0,1,1,1,0,0,2,0,0,0,0,0,0,0,0,0,0,
                       0,1,1,1,1,0,1,0,0,1,0,0,0,1,1,1,1,1,1,0,
                       0,1,0,0,0,0,1,1,1,1,0,0,0,1,0,0,0,0,1,0,
                       0,1,0,0,0,0,0,0,0,0,0,0,0,1,0,0,0,0,1,0,
                       0,1,1,1,1,1,1,0,0,0,0,0,1,1,0,0,0,1,1,0,
                       0,0,0,0,0,0,1,1,1,1,1,1,1,0,0,1,1,1,0,0,
                       0,0,0,0,0,0,0,0,0,0,0,0,0,0,0,1,0,0,0,0,
                       1,1,1,1,1,1,1,1,1,1,1,1,1,1,0,1,0,0,0,0,
                       1,0,0,0,0,0,0,0,0,0,0,0,0,1,0,1,0,0,0,0,
                       1,0,0,1,1,1,1,1,1,1,1,0,0,1,0,1,1,1,0,0,
                       1,0,0,1,0,0,0,0,0,0,1,0,0,1,0,0,0,1,0,0,
                       1,0,0,1,0,0,0,0,0,0,1,0,0,1,0,0,0,1,0,0,
                       1,0,0,1,0,0,0,0,0,0,1,0,0,1,0,0,0,1,0,0,
                       1,0,0,1,1,1,1,1,1,0,1,0,0,1,0,0,0,1,0,0,
                       1,0,0,0,0,0,0,0,1,0,1,0,0,1,0,0,0,1,0,0,
                       1,0,0,0,0,0,0,0,1,0,1,0,0,1,0,0,0,1,0,0,
                       1,1,0,0,0,0,0,0,1,0,1,0,0,1,0,0,0,1,0,0,
                       0,1,1,1,1,1,1,1,1,0,1,0,0,1,1,1,1,1,0,0,
                       0,0,0,0,0,0,0,0,0,0,1,0,0,0,0,0,0,0,0,0,
                       0,0,0,0,0,0,0,0,0,0,3,0,0,0,0,0,0,0,0,0]

            }]
    

}